   MMMMMMMMMMMMMMMMMMMMMMMMM
   M         MMM           M
MMMM  MMMMM  MMM  O  O  O  MMMM
MC    M        M             CM
MMMMMMMM MMMMMMM    MMM    MMMM
   M           MMMMM   MMMMM
   MMMMMMMMMM  M    MMM    M
   MMM         M           M
   MMM  MMMMMMMMMMMMMMMMppMM
   MMM      MMMM           M
   MMMMMMMppMMMMd          M
   MMMMMMM  MMMMMMMMppMMMMMM
   M    M    M             M
   M    p    h             M
   M    p    h            lM
   M    M   dMMMMMMMooMMMMMM
   MMppMMMMMMM             M
   M    M    M       O     M
   M    p    p      O O    M
   M    p    p       O     M
   M    M    M             M
   MMMMMMMMMMM   MMMMMMMMMMM
             M   M
             M 3 M
             MMMMM