          MMMMM
          M 3 M
          M   M
MMMMMMMMMMM   MMMMMMMMMMM
M                       M
M                       M
MMMMMlllMMMMMMMMMoooMMMMM
M       MMMMMMMMM       M
M       MMMMMMMMM       M
M       MMMMMMMMM       M
M          MMM          M
M           M           M
M           M           M
M           M           M
MMMMMpppMMMMM       B   M
M           M           M
M           M           M
M   s       M           M
M           h           M
M           h           M
M           MMMMMMMMMMMMM
M                       M
M                   u   M
M                       M
MMMMMMMMMMM   MMMMMMMMMMM
          M   M
          M C M
          MMMMM