          MMMMM
          M C M
          M   M
MMMMMMMMMMM   MMMMMMMMMMM
M                       M
M                       M
MMMMMlllMMMMMMMMMoooMMMMM
M       MMMMMMMMM       M
M         MMMMM         M
M         MMMMM         M
M          MMM          M
M           M           M
M           M           M
M           h           M
M           h           M
M           M           M
M           M           M
M          MMM          M
M         MMMMM         M
M         MMMMM         M
M       MMMMMMMMM       M
MMMMMlllMMMMMMMMMoooMMMMM
M                       M
M                       M
MMMMMMMMMMM   MMMMMMMMMMM
          M   M
          M 3 M
          MMMMM