   MMMMMMMMMMMMMMMMMMMMMMMMM
   M         MMM           M
MMMM  MMMMM  MMM  L  L  L  MMMM
MC    M        M             CM
MMMMMMMM MMMMMMM    MMM    MMMM
   M           MMMMM   MMMMM
   MMMMMMMMMM  M    MMM    M
   MMM         M           M
   MMM  MMMMMMMMMMMMMMMMppMM
   MMM      MMMM           M
   MMMMMMMppMMMMd          M
   MMMMMMM  MMMMMMMMppMMMMMM
   M    M    M             M
   M    p    h             M
   M    p    h            LM
   M    M   dMMMMMMMooMMMMMM
   MMppMMMMMMM             M
   M    M    M       L     M
   M    p    p      L L    M
   M    p    p       L     M
   M    M    M             M
   MMMMMMMMMMM   MMMMMMMMMMM
             M   M
             M 3 M
             MMMMM