          MMMMM
          M C M
          M   M
MMMMMMMMMMM   MMMMMMMMMMM
M   M b  M     M M      M
M D M    MMpppMM p  B   M
M   M    M     M p      M
MMMMM    MMpppMM M      M
M   M    M     M M      M
M   l    MMpppMM M      M
M   l            M      M
MMMMMMMMMMMMMMMMMM      M
M                       M
MMMMMMMMMMMMMMMMMM      M
M          M     M      M
M  L       M     o      M
M          M     o  O   M
MMMhhMMppMMM     M      M
M                M      M
M  b             MMMMMMMM
M                       M
MMMMMMM              b  M
M L   p                 M
M     p                 M
MMMMMMMMMMM   MMMMMMMMMMM
          M   M
          M 3 M
          MMMMM
