              MMMMM
              M 3 M
              M   M
MMMMMMMMMMMMMMM   MMMMMMMMMMMMMMM
M   l                       o   M
MMMMMMMMooMMMMM   MMMMMllMMMMMMMM
    MMMM     MM   MM     MMMM
    MMMMMMMM MMMMMMM MMMMMMMM
    M        MMMMMMM        M
    M MMMMMMMMMMMMMMMMMMMMM M
    M        MMMMMMM        M
    MMMMMMMM MMMMMMM MMMMMMMM
    MMMM     MMMMMMM    MMMMM
    MMMM MMMMMMMMMMMMMM MMMMM
    M    MMMMMMMMMMMMMM     M
    M  MMMMMMMMMMMMMMMMMMMM M
    M       dMMMMMMMd       M
    MMMMMMMM MMMMMMM MMMMMMMM
    M        MMMMMMM        M
    M MMMMMMMMMMMMMMMMMMMMM M
    M        MMMMMMM        M
    MMMMM  MMMMMMMMMMM  MMMMM
    M      MMMM   MMMM      M
    M MMMMMMMMM   MMMMMMMMM M
    M         l   o         M
    MMMMMMMMMMM   MMMMMMMMMMM
              M   M
              M C M
              MMMMM